//MAP CONVERTED BY dmm2tgm.py THIS HEADER COMMENT PREVENTS RECONVERSION, DO NOT REMOVE
"a" = (
/obj/item/hilbertshotel/ghostdojo,
/turf/open/floor/carpet/purple,
/area/template_noop)

(1,1,1) = {"
a
"}
