//MAP CONVERTED BY dmm2tgm.py THIS HEADER COMMENT PREVENTS RECONVERSION, DO NOT REMOVE
"aK" = (
/obj/structure/fluff/metalpole/end{
	pixel_y = -32
	},
/turf/closed/wall/mineral/titanium/spaceship/nodiagonal,
/area/shuttle/supply)
"bh" = (
/turf/closed/wall/mineral/titanium/nodiagonal,
/area/shuttle/supply)
"cs" = (
/obj/effect/decal/cleanable/dirt/dust,
/obj/effect/turf_decal/box/white/corners{
	dir = 8
	},
/obj/effect/turf_decal/tile/neutral/diagonal_centre,
/obj/effect/turf_decal/tile/neutral/diagonal_edge,
/turf/open/floor/iron/dark/diagonal,
/area/shuttle/supply)
"dK" = (
/obj/effect/decal/cleanable/dirt/dust,
/obj/machinery/button/door/directional/west{
	id = "cargounload";
	name = "Loading Doors";
	dir = 2;
	pixel_x = 8;
	pixel_y = 30
	},
/obj/machinery/button/door/directional/west{
	id = "cargoload";
	name = "Loading Doors";
	dir = 2;
	pixel_x = -8;
	pixel_y = 30
	},
/turf/open/floor/iron/shuttle/cargo{
	dir = 1
	},
/area/shuttle/supply)
"dO" = (
/obj/structure/marker_beacon/burgundy,
/turf/closed/wall/mineral/titanium/spaceship/nodiagonal,
/area/shuttle/supply)
"fh" = (
/obj/effect/decal/cleanable/dirt/dust,
/obj/effect/turf_decal/tile/neutral/diagonal_edge,
/obj/effect/turf_decal/tile/neutral/diagonal_centre,
/obj/machinery/light/directional/east,
/obj/effect/decal/cleanable/dirt/dust,
/obj/effect/turf_decal/box/white/corners{
	dir = 3
	},
/turf/open/floor/iron/dark/diagonal,
/area/shuttle/supply)
"hv" = (
/obj/effect/turf_decal/tile/neutral/diagonal_edge,
/obj/effect/turf_decal/tile/neutral/diagonal_centre,
/obj/effect/decal/cleanable/dirt/dust,
/obj/machinery/light/directional/west,
/obj/effect/decal/cleanable/dirt/dust,
/obj/effect/turf_decal/box/white/corners{
	dir = 1
	},
/turf/open/floor/iron/dark/diagonal,
/area/shuttle/supply)
"hC" = (
/obj/effect/decal/cleanable/dirt/dust,
/turf/open/floor/iron/shuttle/cargo{
	dir = 1
	},
/area/shuttle/supply)
"hV" = (
/obj/effect/decal/cleanable/dirt/dust,
/obj/effect/turf_decal/tile/neutral/diagonal_centre,
/obj/effect/turf_decal/tile/neutral/diagonal_edge,
/turf/open/floor/iron/dark/diagonal,
/area/shuttle/supply)
"kh" = (
/obj/effect/decal/cleanable/dirt/dust,
/obj/effect/turf_decal/tile/neutral/diagonal_edge,
/obj/effect/turf_decal/tile/neutral/diagonal_centre,
/obj/effect/decal/cleanable/dirt/dust,
/obj/effect/turf_decal/box/white/corners{
	dir = 4
	},
/turf/open/floor/iron/dark/diagonal,
/area/shuttle/supply)
"lb" = (
/obj/docking_port/mobile/supply{
	dir = 4
	},
/turf/closed/wall/mineral/titanium/nodiagonal,
/area/shuttle/supply)
"oU" = (
/obj/structure/sign/warning/fire,
/turf/closed/wall/mineral/titanium/spaceship/nodiagonal,
/area/shuttle/supply)
"pD" = (
/obj/effect/decal/cleanable/dirt/dust,
/obj/effect/turf_decal/tile/neutral/diagonal_edge,
/obj/effect/turf_decal/tile/neutral/diagonal_centre,
/obj/effect/decal/cleanable/dirt/dust,
/obj/effect/turf_decal/box/white/corners{
	dir = 8
	},
/obj/structure/sign/departments/cargo{
	pixel_x = 32
	},
/turf/open/floor/iron/dark/diagonal,
/area/shuttle/supply)
"sN" = (
/obj/machinery/power/shuttle_engine/heater,
/obj/structure/window/plasma/spawner/directional/north,
/obj/structure/window/plasma/spawner/directional/east,
/obj/effect/turf_decal/stripes/line{
	dir = 1
	},
/turf/open/floor/plating/airless,
/area/shuttle/supply)
"sR" = (
/obj/effect/decal/cleanable/dirt/dust,
/obj/effect/turf_decal/box/white/corners{
	dir = 3
	},
/obj/effect/turf_decal/tile/neutral/diagonal_centre,
/obj/effect/turf_decal/tile/neutral/diagonal_edge,
/turf/open/floor/iron/dark/diagonal,
/area/shuttle/supply)
"uB" = (
/obj/machinery/power/shuttle_engine/heater,
/obj/structure/window/plasma/spawner/directional/north,
/obj/structure/window/plasma/spawner/directional/west,
/obj/effect/turf_decal/stripes/line{
	dir = 1
	},
/turf/open/floor/plating/airless,
/area/shuttle/supply)
"vd" = (
/obj/effect/decal/cleanable/dirt/dust,
/obj/effect/turf_decal/tile/neutral/diagonal_edge,
/obj/effect/turf_decal/tile/neutral/diagonal_centre,
/obj/effect/decal/cleanable/dirt/dust,
/obj/effect/turf_decal/box/white/corners{
	dir = 1
	},
/turf/open/floor/iron/dark/diagonal,
/area/shuttle/supply)
"wI" = (
/obj/effect/turf_decal/stripes/line,
/obj/structure/fluff/metalpole/end{
	pixel_y = -32
	},
/obj/machinery/power/shuttle_engine/propulsion/burst,
/turf/open/floor/plating/airless,
/area/shuttle/supply)
"zx" = (
/turf/closed/wall/mineral/titanium/spaceship/nodiagonal,
/area/shuttle/supply)
"zP" = (
/obj/effect/decal/cleanable/dirt/dust,
/obj/effect/turf_decal/tile/neutral/diagonal_edge,
/obj/effect/turf_decal/tile/neutral/diagonal_centre,
/obj/structure/sign/departments/cargo/directional/west,
/turf/open/floor/iron/dark/diagonal,
/area/shuttle/supply)
"CR" = (
/obj/machinery/door/airlock/grunge{
	name = "Supply Shuttle Airlock";
	req_access_txt = "31"
	},
/obj/structure/fans/tiny,
/obj/effect/turf_decal/delivery/white,
/turf/open/floor/plating,
/area/shuttle/supply)
"DY" = (
/obj/effect/decal/cleanable/dirt/dust,
/obj/machinery/light/directional/west,
/turf/open/floor/iron/shuttle/cargo{
	dir = 1
	},
/area/shuttle/supply)
"Gf" = (
/obj/effect/decal/cleanable/dirt/dust,
/obj/effect/turf_decal/caution/white,
/turf/open/floor/iron/shuttle/cargo{
	dir = 1
	},
/area/shuttle/supply)
"Kw" = (
/obj/effect/decal/cleanable/dirt/dust,
/obj/effect/decal/cleanable/dirt/dust,
/obj/machinery/light/directional/east,
/turf/open/floor/iron/shuttle/cargo{
	dir = 1
	},
/area/shuttle/supply)
"Ow" = (
/obj/effect/decal/cleanable/dirt/dust,
/obj/effect/turf_decal/tile/neutral/diagonal_edge,
/obj/effect/turf_decal/tile/neutral/diagonal_centre,
/obj/effect/decal/cleanable/dirt/dust,
/turf/open/floor/iron/dark/diagonal,
/area/shuttle/supply)
"PH" = (
/obj/effect/decal/cleanable/dirt/dust,
/obj/effect/turf_decal/tile/neutral/diagonal_edge,
/obj/effect/turf_decal/tile/neutral/diagonal_centre,
/obj/effect/decal/cleanable/dirt/dust,
/obj/structure/sign/departments/cargo{
	pixel_x = 32
	},
/turf/open/floor/iron/dark/diagonal,
/area/shuttle/supply)
"SL" = (
/obj/structure/marker_beacon/olive,
/turf/closed/wall/mineral/titanium/spaceship/nodiagonal,
/area/shuttle/supply)
"Uj" = (
/obj/effect/decal/cleanable/dirt/dust,
/obj/effect/turf_decal/box/white/corners{
	dir = 4
	},
/obj/effect/turf_decal/tile/neutral/diagonal_centre,
/obj/effect/turf_decal/tile/neutral/diagonal_edge,
/obj/structure/sign/departments/cargo/directional/west,
/turf/open/floor/iron/dark/diagonal,
/area/shuttle/supply)
"UC" = (
/obj/effect/decal/cleanable/dirt/dust,
/obj/effect/turf_decal/tile/neutral/diagonal_edge,
/obj/effect/turf_decal/tile/neutral/diagonal_centre,
/turf/open/floor/iron/dark/diagonal,
/area/shuttle/supply)
"UX" = (
/obj/effect/decal/cleanable/dirt/dust,
/obj/effect/turf_decal/loading_area/white,
/turf/open/floor/iron/shuttle/cargo{
	dir = 1
	},
/area/shuttle/supply)
"VP" = (
/obj/effect/decal/cleanable/dirt/dust,
/obj/effect/decal/cleanable/dirt/dust,
/turf/open/floor/iron/shuttle/cargo{
	dir = 1
	},
/area/shuttle/supply)
"WW" = (
/obj/machinery/conveyor{
	id = "cargoload"
	},
/obj/machinery/door/poddoor{
	id = "cargoload";
	name = "Supply Dock Loading Door"
	},
/obj/structure/fans/tiny,
/turf/open/floor/plating,
/area/shuttle/supply)
"Xb" = (
/obj/effect/turf_decal/stripes/line,
/obj/machinery/power/shuttle_engine/propulsion/burst,
/turf/open/floor/plating/airless,
/area/shuttle/supply)
"Xe" = (
/obj/effect/decal/cleanable/dirt/dust,
/obj/effect/turf_decal/loading_area/white{
	dir = 1
	},
/turf/open/floor/iron/shuttle/cargo{
	dir = 1
	},
/area/shuttle/supply)
"Zh" = (
/obj/machinery/conveyor{
	dir = 1;
	id = "cargounload"
	},
/obj/machinery/door/poddoor{
	id = "cargounload";
	name = "Supply Dock Unloading Door"
	},
/obj/structure/fans/tiny,
/turf/open/floor/plating,
/area/shuttle/supply)

(1,1,1) = {"
dO
zx
bh
bh
lb
bh
bh
bh
bh
bh
zx
SL
"}
(2,1,1) = {"
WW
UX
DY
Uj
hV
hV
hV
hV
zP
hv
uB
wI
"}
(3,1,1) = {"
CR
Gf
hC
cs
hV
hV
hV
hV
hV
sR
sN
Xb
"}
(4,1,1) = {"
zx
dK
VP
VP
VP
VP
hC
VP
VP
VP
oU
aK
"}
(5,1,1) = {"
CR
Gf
hC
kh
Ow
Ow
UC
Ow
Ow
vd
uB
Xb
"}
(6,1,1) = {"
Zh
Xe
Kw
pD
Ow
Ow
UC
Ow
PH
fh
sN
wI
"}
(7,1,1) = {"
SL
zx
bh
bh
bh
bh
bh
bh
bh
bh
zx
dO
"}
