//MAP CONVERTED BY dmm2tgm.py THIS HEADER COMMENT PREVENTS RECONVERSION, DO NOT REMOVE
"ah" = (
/obj/machinery/recharge_station,
/obj/effect/turf_decal/bot_white,
/turf/open/floor/iron/dark/textured_large,
/area/shuttle/syndicate/cruiser/hallway)
"bf" = (
/turf/closed/wall/mineral/titanium/nodiagonal,
/area/shuttle/syndicate/cruiser/airlock)
"bg" = (
/obj/machinery/mech_bay_recharge_port{
	dir = 8
	},
/turf/open/floor/iron/dark/textured_large,
/area/shuttle/syndicate/cruiser/engineering)
"bk" = (
/obj/machinery/light/no_nightlight/directional/east,
/turf/open/floor/iron/smooth_large,
/area/shuttle/syndicate/cruiser/armory)
"bw" = (
/obj/machinery/light/no_nightlight/directional/south,
/turf/open/floor/iron/smooth_large,
/area/shuttle/syndicate/cruiser/armory)
"bW" = (
/obj/machinery/computer/monitor{
	dir = 2
	},
/turf/open/floor/iron/dark/textured_large,
/area/shuttle/syndicate/cruiser/bridge)
"ce" = (
/turf/open/floor/iron/smooth_large,
/area/shuttle/syndicate/cruiser/engineering)
"cl" = (
/obj/structure/chair/comfy/shuttle/tactical{
	dir = 1
	},
/turf/open/floor/iron/smooth_large,
/area/shuttle/syndicate/cruiser/bridge)
"cu" = (
/obj/structure/rack/gunrack,
/obj/item/gun/energy/e_gun/stun/blueshield,
/obj/item/gun/energy/e_gun/dragnet,
/obj/effect/turf_decal/bot_white,
/turf/open/floor/iron/dark/textured_large,
/area/shuttle/syndicate/cruiser/hallway)
"cw" = (
/obj/structure/closet/crate,
/obj/item/storage/toolbox/syndicate,
/obj/item/storage/toolbox/syndicate,
/obj/item/storage/toolbox/syndicate,
/obj/item/construction/rcd/loaded,
/obj/item/inducer/syndicate,
/obj/effect/turf_decal/bot_white,
/turf/open/floor/iron/dark/textured_large,
/area/shuttle/syndicate/cruiser/armory)
"cN" = (
/obj/structure/closet/crate/medical,
/turf/open/floor/iron/smooth_large,
/area/shuttle/syndicate/cruiser/engineering)
"de" = (
/obj/machinery/power/shuttle_engine/huge,
/turf/open/floor/plating/airless,
/area/shuttle/syndicate/cruiser)
"dz" = (
/turf/closed/wall/mineral/titanium/spaceship/nodiagonal,
/area/shuttle/syndicate/cruiser)
"dF" = (
/obj/machinery/computer/records/security/syndie{
	dir = 4
	},
/turf/open/floor/iron/dark/textured_large,
/area/shuttle/syndicate/cruiser/hallway)
"dQ" = (
/turf/closed/wall/mineral/titanium/nodiagonal,
/area/shuttle/syndicate/cruiser/brig)
"dR" = (
/obj/structure/closet/secure_closet/wall{
	pixel_y = 32
	},
/obj/effect/turf_decal/bot_white/right,
/turf/open/floor/iron/dark/textured_large,
/area/shuttle/syndicate/cruiser/hallway)
"dT" = (
/obj/structure/fans/tiny,
/obj/machinery/door/airlock/external/glass,
/obj/effect/mapping_helpers/airlock/cutaiwire,
/obj/effect/mapping_helpers/airlock/access/any/syndicate/general,
/obj/machinery/button/door{
	id = "syndicatecruiserhatchesright";
	name = "hatches";
	pixel_y = 32;
	req_access = list("syndicate")
	},
/obj/machinery/door/poddoor{
	id = "syndicatecruiserhatchesright"
	},
/obj/docking_port/mobile{
	dir = 8;
	hidden = 1;
	shuttle_id = "goldeneye_cruiser";
	movement_force = list("KNOCKDOWN"=0,"THROW"=0);
	name = "goldeneye cruiser";
	port_direction = 4
	},
/turf/open/floor/iron/dark/textured_large,
/area/shuttle/syndicate/cruiser/airlock)
"eh" = (
/obj/structure/chair/stool/directional/east,
/obj/machinery/light/no_nightlight/directional/west,
/turf/open/floor/iron/smooth_large,
/area/shuttle/syndicate/cruiser/brig)
"er" = (
/turf/closed/wall/mineral/titanium/nodiagonal,
/area/shuttle/syndicate/cruiser/bridge)
"et" = (
/obj/structure/closet/crate,
/obj/item/stack/sheet/rglass{
	amount = 30;
	pixel_x = 2;
	pixel_y = -2
	},
/obj/item/stack/sheet/rglass{
	amount = 30;
	pixel_x = 2;
	pixel_y = -2
	},
/obj/item/stack/sheet/iron/fifty,
/obj/item/stack/sheet/iron/fifty,
/obj/item/storage/toolbox/electrical,
/obj/item/storage/box/lights,
/obj/effect/turf_decal/bot_white,
/obj/machinery/light/no_nightlight/directional/east,
/turf/open/floor/iron/dark/textured_large,
/area/shuttle/syndicate/cruiser/armory)
"eU" = (
/obj/structure/bed/double/pod,
/obj/item/bedsheet/syndie/double,
/turf/open/floor/iron/dark/textured_large,
/area/shuttle/syndicate/cruiser/hallway)
"fo" = (
/obj/machinery/computer/crew/syndie{
	dir = 4
	},
/turf/open/floor/iron/dark/textured_large,
/area/shuttle/syndicate/cruiser/bridge)
"fH" = (
/obj/structure/chair/comfy/shuttle/tactical{
	dir = 8
	},
/obj/machinery/light/no_nightlight/directional/south,
/turf/open/floor/iron/smooth_large,
/area/shuttle/syndicate/cruiser/bridge)
"gO" = (
/obj/machinery/door/airlock/external/glass,
/obj/effect/mapping_helpers/airlock/cutaiwire,
/turf/open/floor/iron/dark/textured_large,
/area/shuttle/syndicate/cruiser/airlock)
"ha" = (
/turf/closed/wall/mineral/titanium,
/area/shuttle/syndicate/cruiser/hallway)
"hk" = (
/obj/structure/rack/shelf,
/obj/item/storage/box/handcuffs{
	pixel_y = -3
	},
/obj/item/storage/box/handcuffs{
	pixel_y = 4
	},
/obj/effect/turf_decal/bot_white,
/turf/open/floor/iron/dark/textured_large,
/area/shuttle/syndicate/cruiser/armory)
"hy" = (
/obj/machinery/light/no_nightlight/directional/south,
/turf/open/floor/iron/smooth_large,
/area/shuttle/syndicate/cruiser/brig)
"iU" = (
/obj/effect/turf_decal/bot_white,
/obj/machinery/portable_atmospherics/canister/air,
/turf/open/floor/iron/dark/textured_large,
/area/shuttle/syndicate/cruiser/airlock)
"ke" = (
/obj/structure/bed/maint,
/obj/item/bedsheet/grey,
/turf/open/floor/iron/smooth_large,
/area/shuttle/syndicate/cruiser/brig)
"kh" = (
/obj/machinery/computer/security{
	dir = 8;
	network = list("gate");
	name = "Gate Camera Control"
	},
/obj/effect/turf_decal/bot_white,
/turf/open/floor/iron/dark/textured_large,
/area/shuttle/syndicate/cruiser/hallway)
"lO" = (
/obj/structure/table/survival_pod,
/obj/structure/bedsheetbin{
	pixel_y = 3
	},
/turf/open/floor/iron/smooth_large,
/area/shuttle/syndicate/cruiser/brig)
"mP" = (
/obj/machinery/door/poddoor/preopen{
	id = "syndicatecruiserwindows"
	},
/obj/effect/spawner/structure/window/reinforced/shuttle,
/turf/open/floor/plating,
/area/shuttle/syndicate/cruiser/bridge)
"nZ" = (
/turf/open/floor/catwalk_floor/iron_smooth,
/area/shuttle/syndicate/cruiser/hallway)
"ol" = (
/obj/machinery/door/airlock/external/glass,
/obj/effect/mapping_helpers/airlock/cutaiwire,
/obj/effect/mapping_helpers/airlock/access/any/syndicate/general,
/obj/machinery/button/door{
	id = "syndicatecruiserhatchesright";
	name = "hatches";
	pixel_y = 32;
	req_access = list("syndicate")
	},
/obj/machinery/door/poddoor{
	id = "syndicatecruiserhatchesright"
	},
/turf/open/floor/iron/dark/textured_large,
/area/shuttle/syndicate/cruiser/airlock)
"oH" = (
/obj/structure/tank_holder/extinguisher,
/obj/effect/turf_decal/bot_white,
/turf/open/floor/iron/dark/textured_large,
/area/shuttle/syndicate/cruiser/hallway)
"pg" = (
/turf/open/floor/catwalk_floor/iron_smooth,
/area/shuttle/syndicate/cruiser/engineering)
"pX" = (
/turf/open/floor/plating/airless,
/area/shuttle/syndicate/cruiser)
"ql" = (
/obj/structure/closet/secure_closet{
	name = "Secure Storage";
	req_access = list("syndicate")
	},
/obj/item/storage/box/handcuffs{
	pixel_x = -4;
	pixel_y = 4
	},
/obj/item/storage/box/zipties{
	pixel_x = -2
	},
/obj/item/storage/box/bodybags,
/obj/item/stack/sticky_tape,
/obj/item/melee/baton/security/loaded,
/obj/effect/turf_decal/bot_white,
/turf/open/floor/iron/dark/textured_large,
/area/shuttle/syndicate/cruiser/hallway)
"qG" = (
/obj/machinery/space_heater,
/obj/effect/turf_decal/bot_white,
/obj/machinery/light/no_nightlight/directional/west,
/turf/open/floor/iron/dark/textured_large,
/area/shuttle/syndicate/cruiser/hallway)
"qU" = (
/obj/structure/marker_beacon/burgundy,
/turf/closed/wall/mineral/titanium,
/area/shuttle/syndicate/cruiser/airlock)
"rj" = (
/obj/machinery/door/poddoor/preopen{
	id = "syndicatecruiserwindows"
	},
/obj/effect/spawner/structure/window/reinforced/shuttle,
/turf/open/floor/plating,
/area/shuttle/syndicate/cruiser/hallway)
"rk" = (
/obj/machinery/computer/camera_advanced/syndie{
	dir = 4
	},
/turf/open/floor/iron/dark/textured_large,
/area/shuttle/syndicate/cruiser/bridge)
"ru" = (
/turf/closed/wall/mineral/titanium/nodiagonal,
/area/shuttle/syndicate/cruiser/hallway)
"rA" = (
/obj/structure/chair/comfy/shuttle/tactical{
	dir = 1
	},
/obj/effect/turf_decal/bot,
/turf/open/floor/iron/dark/textured_large,
/area/shuttle/syndicate/cruiser/armory)
"rF" = (
/obj/structure/table/reinforced,
/obj/item/radio/intercom{
	freerange = 1;
	name = "Syndicate Radio Intercom"
	},
/turf/open/floor/iron/dark/textured_large,
/area/shuttle/syndicate/cruiser/bridge)
"sP" = (
/obj/structure/tank_dispenser/oxygen,
/obj/effect/turf_decal/bot_white,
/turf/open/floor/iron/dark/textured_large,
/area/shuttle/syndicate/cruiser/armory)
"sX" = (
/obj/machinery/door/airlock/hatch{
	name = "Armory"
	},
/obj/effect/mapping_helpers/airlock/cutaiwire,
/obj/effect/mapping_helpers/airlock/access/any/syndicate/general,
/turf/open/floor/iron/dark/textured_large,
/area/shuttle/syndicate/cruiser/hallway)
"ts" = (
/obj/machinery/recharger{
	pixel_x = -9;
	pixel_y = -31
	},
/obj/machinery/recharger{
	pixel_x = 8;
	pixel_y = -31
	},
/turf/open/floor/iron/smooth_large,
/area/shuttle/syndicate/cruiser/bridge)
"ur" = (
/obj/structure/window/reinforced/survival_pod/spawner/directional/north,
/obj/structure/chair/stool/directional/south,
/turf/open/floor/iron/smooth_large,
/area/shuttle/syndicate/cruiser/brig)
"uS" = (
/obj/structure/marker_beacon/olive,
/turf/closed/wall/mineral/titanium/spaceship/nodiagonal,
/area/shuttle/syndicate/cruiser/engineering)
"vZ" = (
/obj/structure/window/reinforced/survival_pod/spawner/directional/north,
/obj/structure/bed/maint,
/obj/item/bedsheet/grey,
/turf/open/floor/iron/smooth_large,
/area/shuttle/syndicate/cruiser/brig)
"wb" = (
/obj/machinery/light/no_nightlight/directional/north,
/turf/open/floor/iron/smooth_half,
/area/shuttle/syndicate/cruiser/hallway)
"ws" = (
/obj/structure/tank_holder/oxygen/yellow,
/obj/effect/turf_decal/bot_white,
/obj/machinery/light/no_nightlight/directional/south,
/turf/open/floor/iron/dark/textured_large,
/area/shuttle/syndicate/cruiser/airlock)
"wI" = (
/obj/structure/rack/gunrack,
/obj/item/gun/energy/disabler/smg,
/obj/item/gun/energy/disabler/smg,
/obj/effect/turf_decal/bot_white,
/turf/open/floor/iron/dark/textured_large,
/area/shuttle/syndicate/cruiser/armory)
"xL" = (
/obj/machinery/autolathe/hacked,
/turf/open/floor/iron/dark/textured_large,
/area/shuttle/syndicate/cruiser/armory)
"xT" = (
/obj/structure/closet/crate/radiation,
/obj/machinery/light/no_nightlight/directional/south,
/turf/open/floor/iron/smooth_large,
/area/shuttle/syndicate/cruiser/engineering)
"xX" = (
/obj/structure/window/reinforced/survival_pod/spawner/directional/east{
	pixel_x = 3
	},
/obj/structure/tank_holder/extinguisher,
/turf/open/floor/iron/smooth_large,
/area/shuttle/syndicate/cruiser/engineering)
"yT" = (
/obj/effect/turf_decal/tile/neutral/diagonal_edge,
/obj/structure/table,
/obj/structure/reagent_dispensers/servingdish,
/obj/machinery/light/no_nightlight/directional/north,
/turf/open/floor/iron/dark/diagonal,
/area/shuttle/syndicate/cruiser/brig)
"zh" = (
/obj/machinery/suit_storage_unit/syndicate,
/obj/effect/turf_decal/bot_white,
/turf/open/floor/iron/dark/textured_large,
/area/shuttle/syndicate/cruiser/hallway)
"zo" = (
/turf/open/floor/iron/smooth,
/area/shuttle/syndicate/cruiser/hallway)
"zL" = (
/turf/template_noop,
/area/template_noop)
"AM" = (
/obj/effect/turf_decal/delivery/white,
/obj/machinery/door/airlock/command/glass{
	name = "Bridge"
	},
/obj/effect/mapping_helpers/airlock/access/any/syndicate/general,
/obj/effect/mapping_helpers/airlock/cutaiwire,
/turf/open/floor/iron/dark/textured_large,
/area/shuttle/syndicate/cruiser/bridge)
"Bd" = (
/obj/machinery/portable_atmospherics/canister/oxygen,
/obj/effect/turf_decal/bot_white,
/turf/open/floor/iron/dark/textured_large,
/area/shuttle/syndicate/cruiser/hallway)
"Bx" = (
/obj/structure/marker_beacon/olive,
/turf/closed/wall/mineral/titanium/nodiagonal,
/area/shuttle/syndicate/cruiser/armory)
"CH" = (
/turf/open/floor/iron/smooth_large,
/area/shuttle/syndicate/cruiser/hallway)
"CI" = (
/turf/open/floor/catwalk_floor/iron_smooth,
/area/shuttle/syndicate/cruiser/bridge)
"CT" = (
/obj/effect/turf_decal/stripes/line,
/obj/structure/fluff/metalpole/end{
	pixel_y = -32
	},
/obj/machinery/power/shuttle_engine/large,
/turf/open/floor/plating/airless,
/area/shuttle/syndicate/cruiser)
"Ei" = (
/obj/structure/closet/crate/large,
/turf/open/floor/iron/smooth_large,
/area/shuttle/syndicate/cruiser/engineering)
"El" = (
/turf/closed/wall/mineral/titanium,
/area/shuttle/syndicate/cruiser/airlock)
"EL" = (
/obj/structure/shipping_container/kahraman,
/turf/open/floor/iron/smooth_large,
/area/shuttle/syndicate/cruiser/engineering)
"FA" = (
/obj/structure/table/reinforced,
/obj/machinery/button/door{
	id = "syndicatecruiserwindows";
	name = "Window Blast Doors";
	pixel_x = -5;
	pixel_y = 7;
	req_access = list("syndicate")
	},
/obj/machinery/button/door{
	id = "syndicatecruisercargo";
	name = "Cargo Shutters";
	pixel_x = -5;
	req_access = list("syndicate");
	pixel_y = -2
	},
/turf/open/floor/iron/dark/textured_large,
/area/shuttle/syndicate/cruiser/bridge)
"FH" = (
/turf/open/floor/iron/smooth_half,
/area/shuttle/syndicate/cruiser/hallway)
"FJ" = (
/obj/machinery/space_heater/wall_mounted/directional/north,
/turf/open/floor/iron/smooth_large,
/area/shuttle/syndicate/cruiser/brig)
"FO" = (
/turf/open/floor/catwalk_floor/iron_dark,
/area/shuttle/syndicate/cruiser/airlock)
"Gz" = (
/obj/machinery/door/poddoor/preopen{
	id = "syndicatecruiserwindows"
	},
/obj/effect/spawner/structure/window/reinforced/shuttle,
/turf/open/floor/plating,
/area/shuttle/syndicate/cruiser/brig)
"GD" = (
/obj/effect/turf_decal/stripes/line{
	dir = 8
	},
/obj/effect/turf_decal/stripes/line{
	dir = 4
	},
/obj/machinery/door/poddoor/shutters{
	id = "syndicatecruisercargo"
	},
/turf/open/floor/iron/dark/textured_large,
/area/shuttle/syndicate/cruiser/engineering)
"GN" = (
/obj/structure/window/reinforced/survival_pod/spawner/directional/west{
	pixel_x = -4
	},
/obj/structure/closet/crate/large,
/obj/machinery/light/no_nightlight/directional/north,
/turf/open/floor/iron/smooth_large,
/area/shuttle/syndicate/cruiser/engineering)
"Hd" = (
/obj/machinery/door/window/survival_pod/left/directional/south,
/turf/open/floor/engine,
/area/shuttle/syndicate/cruiser/engineering)
"Hm" = (
/obj/machinery/portable_atmospherics/canister/nitrogen,
/obj/effect/turf_decal/bot_white,
/turf/open/floor/iron/dark/textured_large,
/area/shuttle/syndicate/cruiser/hallway)
"Hq" = (
/obj/machinery/door/window/survival_pod/left/directional/north{
	req_access = list("syndicate");
	name = "Holding Cell"
	},
/turf/open/floor/iron/smooth_large,
/area/shuttle/syndicate/cruiser/brig)
"HE" = (
/turf/closed/wall/mineral/titanium/spaceship,
/area/shuttle/syndicate/cruiser)
"JA" = (
/obj/structure/marker_beacon/olive,
/turf/closed/wall/mineral/titanium/nodiagonal,
/area/shuttle/syndicate/cruiser/hallway)
"JF" = (
/obj/structure/rack/shelf,
/obj/item/bodybag/environmental/prisoner/syndicate,
/obj/item/bodybag/environmental/prisoner/syndicate{
	pixel_y = 7
	},
/obj/effect/turf_decal/bot_white,
/turf/open/floor/iron/dark/textured_large,
/area/shuttle/syndicate/cruiser/armory)
"JN" = (
/obj/machinery/light/no_nightlight/directional/west,
/turf/open/floor/iron/smooth_large,
/area/shuttle/syndicate/cruiser/engineering)
"JW" = (
/obj/effect/turf_decal/stripes/line,
/turf/open/floor/plating/airless,
/area/shuttle/syndicate/cruiser)
"JY" = (
/turf/closed/wall/mineral/titanium/nodiagonal,
/area/shuttle/syndicate/cruiser/armory)
"KN" = (
/obj/effect/turf_decal/bot_white,
/obj/machinery/portable_atmospherics/scrubber,
/obj/machinery/light/no_nightlight/directional/south,
/turf/open/floor/iron/dark/textured_large,
/area/shuttle/syndicate/cruiser/airlock)
"LI" = (
/obj/structure/marker_beacon/olive,
/turf/closed/wall/mineral/titanium/spaceship/nodiagonal,
/area/shuttle/syndicate/cruiser)
"Ma" = (
/obj/structure/marker_beacon/burgundy,
/turf/closed/wall/mineral/titanium/spaceship/nodiagonal,
/area/shuttle/syndicate/cruiser)
"MD" = (
/obj/machinery/door/airlock/hatch{
	name = "Holding Chamber"
	},
/obj/effect/mapping_helpers/airlock/cutaiwire,
/obj/effect/mapping_helpers/airlock/access/any/syndicate/general,
/turf/open/floor/iron/dark/textured_large,
/area/shuttle/syndicate/cruiser/brig)
"MO" = (
/obj/structure/marker_beacon/burgundy,
/turf/closed/wall/mineral/titanium,
/area/shuttle/syndicate/cruiser/bridge)
"Nq" = (
/obj/machinery/recharge_station,
/obj/effect/turf_decal/bot_white,
/turf/open/floor/iron/dark/textured_large,
/area/shuttle/syndicate/cruiser/airlock)
"NE" = (
/obj/structure/closet/secure_closet/wall{
	pixel_x = -32
	},
/turf/open/floor/iron/smooth_large,
/area/shuttle/syndicate/cruiser/hallway)
"Om" = (
/obj/effect/turf_decal/stripes/line{
	dir = 8
	},
/obj/effect/turf_decal/stripes/line{
	dir = 4
	},
/obj/machinery/door/poddoor/shutters{
	id = "syndicatecruisercargo"
	},
/turf/open/floor/engine,
/area/shuttle/syndicate/cruiser/engineering)
"Oy" = (
/obj/machinery/power/shuttle_engine/heater,
/turf/open/floor/plating/airless,
/area/shuttle/syndicate/cruiser)
"Pj" = (
/obj/structure/rack/shelf,
/obj/item/stack/sheet/glass/fifty,
/obj/item/stack/sheet/iron/fifty,
/obj/item/stack/sheet/iron/fifty,
/obj/effect/turf_decal/bot_white,
/obj/machinery/light/no_nightlight/directional/west,
/turf/open/floor/iron/dark/textured_large,
/area/shuttle/syndicate/cruiser/armory)
"PB" = (
/obj/structure/table/survival_pod,
/obj/effect/turf_decal/tile/neutral/diagonal_edge,
/obj/item/reagent_containers/cup/bowl,
/obj/item/reagent_containers/cup/bowl{
	pixel_y = 5
	},
/obj/item/reagent_containers/cup/bowl{
	pixel_y = 10
	},
/turf/open/floor/iron/dark/diagonal,
/area/shuttle/syndicate/cruiser/brig)
"PL" = (
/turf/open/floor/iron/smooth,
/area/shuttle/syndicate/cruiser/brig)
"QP" = (
/obj/machinery/ammo_workbench/unlocked,
/obj/structure/extinguisher_cabinet/directional/north,
/obj/effect/turf_decal/bot_white,
/turf/open/floor/iron/dark/textured_large,
/area/shuttle/syndicate/cruiser/armory)
"QU" = (
/obj/machinery/light/no_nightlight/directional/east,
/turf/open/floor/catwalk_floor/iron_smooth,
/area/shuttle/syndicate/cruiser/hallway)
"QV" = (
/obj/machinery/computer/mech_bay_power_console{
	dir = 1;
	pixel_y = -32;
	density = 0
	},
/turf/open/floor/iron/smooth_large,
/area/shuttle/syndicate/cruiser/engineering)
"Re" = (
/obj/machinery/computer/shuttle/goldeneye_cruiser,
/turf/open/floor/iron/dark/textured_large,
/area/shuttle/syndicate/cruiser/bridge)
"RB" = (
/obj/vehicle/sealed/mecha/ripley/deathripley,
/obj/effect/turf_decal/bot_red,
/turf/open/floor/iron/recharge_floor,
/area/shuttle/syndicate/cruiser/engineering)
"SI" = (
/obj/machinery/door/airlock/hatch{
	name = "Armory"
	},
/obj/effect/mapping_helpers/airlock/cutaiwire,
/obj/effect/mapping_helpers/airlock/access/any/syndicate/general,
/turf/open/floor/iron/dark/textured_large,
/area/shuttle/syndicate/cruiser/armory)
"SK" = (
/turf/closed/wall/mineral/titanium,
/area/shuttle/syndicate/cruiser/armory)
"Tr" = (
/obj/structure/window/reinforced/survival_pod/spawner/directional/east{
	pixel_x = 3
	},
/obj/machinery/door/window/survival_pod/left/directional/south,
/turf/open/floor/engine,
/area/shuttle/syndicate/cruiser/engineering)
"TJ" = (
/turf/closed/wall/mineral/titanium/nodiagonal,
/area/shuttle/syndicate/cruiser/engineering)
"Ua" = (
/obj/machinery/power/shuttle_engine/heater,
/obj/structure/window/reinforced/survival_pod/spawner/directional/west,
/obj/structure/window/reinforced/survival_pod/spawner/directional/east,
/obj/structure/window/reinforced/survival_pod/spawner/directional/north,
/turf/open/floor/plating/airless,
/area/shuttle/syndicate/cruiser)
"Ud" = (
/turf/open/floor/catwalk_floor/iron_smooth,
/area/shuttle/syndicate/cruiser/armory)
"Vm" = (
/obj/machinery/light/no_nightlight/directional/south,
/turf/open/floor/iron/smooth_half,
/area/shuttle/syndicate/cruiser/hallway)
"VU" = (
/turf/open/floor/iron/smooth_large,
/area/shuttle/syndicate/cruiser/armory)
"Wb" = (
/obj/machinery/space_heater/wall_mounted/directional/west,
/obj/structure/table,
/obj/effect/spawner/random/entertainment/deck,
/turf/open/floor/iron/smooth_large,
/area/shuttle/syndicate/cruiser/brig)
"Wk" = (
/obj/machinery/door/poddoor/preopen{
	id = "syndicatecruiserwindows"
	},
/obj/effect/spawner/structure/window/reinforced/shuttle,
/turf/open/floor/plating,
/area/shuttle/syndicate/cruiser/airlock)
"Wz" = (
/obj/structure/marker_beacon/olive,
/turf/closed/wall/mineral/titanium,
/area/shuttle/syndicate/cruiser/bridge)
"WF" = (
/obj/effect/turf_decal/stripes/line,
/obj/structure/fluff/metalpole/end{
	pixel_y = -32
	},
/obj/machinery/power/shuttle_engine/propulsion,
/turf/open/floor/plating/airless,
/area/shuttle/syndicate/cruiser)
"Xu" = (
/obj/machinery/computer/camera_advanced/shuttle_docker/goldeneye_cruiser,
/turf/open/floor/iron/dark/textured_large,
/area/shuttle/syndicate/cruiser/bridge)
"Yk" = (
/obj/structure/closet/generic/wall/empty{
	pixel_x = 32
	},
/obj/item/binoculars,
/obj/item/binoculars,
/turf/open/floor/iron/smooth_large,
/area/shuttle/syndicate/cruiser/bridge)
"YJ" = (
/turf/open/floor/catwalk_floor/iron_smooth,
/area/shuttle/syndicate/cruiser/brig)
"Zf" = (
/turf/open/floor/iron/smooth,
/area/shuttle/syndicate/cruiser/armory)
"Zm" = (
/turf/open/floor/iron/smooth_large,
/area/shuttle/syndicate/cruiser/brig)
"Zy" = (
/obj/machinery/light/no_nightlight/directional/east,
/turf/open/floor/iron/smooth_large,
/area/shuttle/syndicate/cruiser/bridge)
"ZC" = (
/obj/machinery/door/window/survival_pod/left/directional/south,
/obj/structure/window/reinforced/survival_pod/spawner/directional/west{
	pixel_x = -4
	},
/turf/open/floor/engine,
/area/shuttle/syndicate/cruiser/engineering)

(1,1,1) = {"
zL
zL
Wz
mP
mP
er
dz
Ua
WF
zL
zL
SK
Bx
SK
zL
zL
zL
zL
zL
ha
JA
ru
Ma
HE
Oy
pX
CT
"}
(2,1,1) = {"
MO
mP
er
fo
rk
er
dz
dz
dz
JY
JY
JY
wI
JY
JY
rj
rj
rj
ru
ru
dF
ru
ru
dz
Oy
pX
JW
"}
(3,1,1) = {"
mP
Xu
FA
rF
fH
er
ru
ru
JY
JY
QP
Pj
VU
hk
JY
Bd
Hm
CH
NE
NE
CH
ql
ru
Oy
pX
pX
de
"}
(4,1,1) = {"
mP
Re
cl
CI
ts
er
qG
oH
JY
VU
VU
VU
VU
Zf
SI
QU
nZ
CH
nZ
QU
zo
ah
ru
Oy
pX
pX
pX
"}
(5,1,1) = {"
mP
bW
cl
Zy
Yk
AM
zo
zo
SI
Zf
Ud
Ud
Ud
VU
JY
bf
Wk
gO
bf
dQ
MD
Gz
dQ
Oy
pX
pX
pX
"}
(6,1,1) = {"
Wz
mP
mP
er
er
er
sX
ru
JY
VU
VU
VU
VU
bk
JF
bf
iU
FO
KN
dQ
PL
lO
dQ
dz
dz
dz
dz
"}
(7,1,1) = {"
zL
zL
zL
ru
zh
zo
zo
ru
xL
VU
bw
JY
JY
JY
JY
bf
Wk
gO
bf
dQ
FJ
hy
dQ
dQ
dQ
dQ
dQ
"}
(8,1,1) = {"
zL
zL
zL
ru
dR
nZ
FH
ru
cw
VU
Ud
rA
TJ
Tr
JN
Ei
ce
ce
RB
Gz
YJ
Zm
ur
Wb
eh
ke
Gz
"}
(9,1,1) = {"
zL
zL
zL
ru
wb
nZ
Vm
ru
et
VU
Ud
rA
TJ
xX
pg
pg
pg
ce
bg
Gz
YJ
Zm
Hq
YJ
Zm
Gz
Gz
"}
(10,1,1) = {"
zL
zL
zL
ru
cu
eU
kh
ru
JY
sP
Zf
rA
TJ
Hd
ce
ce
EL
QV
TJ
dQ
Zm
Zm
vZ
Zm
ke
Gz
zL
"}
(11,1,1) = {"
zL
zL
zL
ha
ru
rj
ru
bf
bf
ol
bf
bf
bf
GN
pg
pg
pg
xT
dQ
PB
Zm
hy
dQ
dQ
dQ
dQ
zL
"}
(12,1,1) = {"
zL
zL
zL
zL
zL
zL
zL
bf
Nq
FO
ws
bf
bf
ZC
ce
ce
ce
cN
dQ
yT
Zm
dQ
dQ
dz
dz
dz
zL
"}
(13,1,1) = {"
zL
zL
zL
zL
zL
zL
zL
qU
bf
dT
bf
El
bf
uS
Om
GD
GD
uS
dQ
Gz
Gz
dQ
LI
dz
Oy
WF
zL
"}
